1111111111111111
1000000100000001
10100C1110111101
1EX00000000100P1
1111111111111111