1111111111111
10000000000C1
1000011101001
10P000E000X01
1111111111111