1111111111111
1CXCCCCCCCCC1
1C1111CC111C1
1C1111C1111C1
1C1111C111111
1CCCCCCCCCCC1
1C1111C1C1111
1CCCCCC0CCCC1
111111C111101
111111C100001
111111C101111
1ECCCCC001001
111111C101111
111111C100001
111111C101111
1CCCCCCCCCCC1
1C1111C1111C1
1CCC11CCCCCC1
111C11C1C1111
1CCPCCC1CCCC1
1C111111111C1
1CCCCCCCCCCC1
1111111111111