1111111111111111111111
111CCC1111111111111111
111C1C1111111111111111
1CCC100P00000000111111
1C1C111C11111010111111
1C1C111C1111101C001111
1C1C111C11011010111111
1C1C111C1101111C001111
1C1C111C1000111X111011
1CCCCCCC101011000000E1
1111111111111111111111